{
    "琼海": "BAR",
    "武冈": "WGN",
    "三明": "SQJ",
    "五大连池": "DTU",
    "遵义": "ZYI",
    "莎车": "QSZ",
    "北京": "BJS",
    "长春": "CGQ",
    "长沙": "CSX",
    "成都": "CTU",
    "重庆": "CKG",
    "大连": "DLC",
    "福州": "FOC",
    "广州": "CAN",
    "贵阳": "KWE",
    "海口": "HAK",
    "杭州": "HGH",
    "哈尔滨": "HRB",
    "呼和浩特": "HET",
    "济南": "TNA",
    "昆明": "KMG",
    "南昌": "KHN",
    "南京": "NKG",
    "南宁": "NNG",
    "青岛": "TAO",
    "三亚": "SYX",
    "上海": "SHA",
    "沈阳": "SHE",
    "深圳": "SZX",
    "石家庄": "SJW",
    "太原": "TYN",
    "天津": "TSN",
    "乌鲁木齐": "URC",
    "温州": "WNZ",
    "武汉": "WUH",
    "厦门": "XMN",
    "西安": "SIA",
    "郑州": "CGO",
    "阿克苏": "AKU",
    "阿勒泰": "AAT",
    "阿拉善左旗": "AXF",
    "阿拉善右旗": "RHT",
    "安顺": "AVA",
    "安康": "AKA",
    "安庆": "AQG",
    "鞍山": "AOG",
    "阿尔山": "YIE",
    "百色": "AEB",
    "白山": "NBS",
    "昌都": "BPX",
    "保山": "BSD",
    "包头": "BAV",
    "巴彦淖尔": "RLK",
    "北海": "BHY",
    "毕节": "BFJ",
    "博乐": "BPL",
    "布尔津": "KJI",
    "常德": "CGD",
    "长治": "CIH",
    "常州": "CZX",
    "朝阳": "CHG",
    "赤峰": "CIF",
    "池州": "JUH",
    "大理": "DLU",
    "丹东": "DDG",
    "稻城": "DCY",
    "大庆": "DQA",
    "大同": "DAT",
    "达州": "DAX",
    "张家界": "DYG",
    "迪庆": "DIG",
    "鄂尔多斯": "DSN",
    "东营": "DOY",
    "敦煌": "DNH",
    "阿拉善额济纳旗": "EJN",
    "恩施": "ENH",
    "二连浩特": "ERL",
    "佛山": "FUO",
    "阜阳": "FUG",
    "抚远": "FYJ",
    "赣州": "KOW",
    "格尔木": "GOQ",
    "广元": "GYS",
    "桂林": "KWL",
    "固原": "GYU",
    "海拉尔": "HLD",
    "哈密": "HMI",
    "邯郸": "HDG",
    "汉中": "HZG",
    "合肥": "HFE",
    "黑河": "HEK",
    "神农架": "HPG",
    "和田": "HTN",
    "淮安": "HIA",
    "怀化": "HJJ",
    "吉安": "JGS",
    "加格达奇": "JGD",
    "佳木斯": "JMU",
    "嘉峪关": "JGN",
    "金昌": "JIC",
    "景德镇": "JDZ",
    "景洪": "JHG",
    "济宁": "JNG",
    "泉州": "JJN",
    "锦州": "JNZ",
    "鸡西": "JXA",
    "凯里": "KJH",
    "康定": "KGT",
    "克拉玛依": "KRY",
    "喀什": "KHG",
    "库尔勒": "KRL",
    "库车": "KCA",
    "兰州": "LHW",
    "拉萨": "LXA",
    "连云港": "LYG",
    "荔波": "LLB",
    "丽江": "LJG",
    "临沧": "LNJ",
    "临沂": "LYI",
    "黎平": "HZH",
    "柳州": "LZH",
    "龙岩": "LCX",
    "洛阳": "LYA",
    "泸州": "LZO",
    "芒": "LUM",
    "满洲里": "NZH",
    "梅县": "MXZ",
    "绵阳": "MIG",
    "漠河": "OHE",
    "牡丹江": "MDG",
    "南充": "NAO",
    "南通": "NTG",
    "南阳": "NNY",
    "宁波": "NGB",
    "林芝": "LZY",
    "攀枝花": "PZI",
    "黔江": "JIQ",
    "且末": "IQM",
    "庆阳": "IQN",
    "齐齐哈尔": "NDG",
    "衢州": "JUZ",
    "揭阳": "SWA",
    "阿里": "NGQ",
    "日喀则": "DDR",
    "普洱": "SYM",
    "九寨沟": "JZH",
    "塔城": "TCG",
    "台州": "HYN",
    "唐山": "TVS",
    "腾冲": "TCZ",
    "天水": "THQ",
    "通辽": "TGO",
    "铜仁": "TEN",
    "黄山": "TXN",
    "吐鲁番": "TLQ",
    "乌兰浩特": "HLH",
    "万州": "WXN",
    "潍坊": "WEF",
    "威海": "WEH",
    "文山": "WNH",
    "乌海": "WUA",
    "无锡": "WUX",
    "武夷山": "WUS",
    "梧州": "WUZ",
    "甘南": "GXH",
    "襄阳": "XFN",
    "西昌": "XIC",
    "锡林浩特": "XIL",
    "兴义": "ACX",
    "西宁": "XNN",
    "新源": "NLT",
    "徐州": "XUZ",
    "延安": "ENY",
    "盐城": "YNZ",
    "扬州": "YTY",
    "延吉": "YNJ",
    "烟台": "YNT",
    "宜宾": "YBP",
    "宜昌": "YIH",
    "伊春": "LDS",
    "宜春": "YIC",
    "银川": "INC",
    "伊宁": "YIN",
    "义乌": "YIW",
    "永州": "LLF",
    "榆林": "UYN",
    "运城": "YCU",
    "玉树": "YUS",
    "张家口": "ZQZ",
    "张掖": "YZY",
    "湛江": "ZHA",
    "昭通": "ZAT",
    "中卫": "ZHY",
    "舟山": "HSN",
    "珠海": "ZUH",
    "富蕴": "FYN",
    "衡阳": "HNY",
    "惠州": "HUZ",
    "石河子": "SHF",
    "通化": "TNH",
    "建三江": "JSJ",
    "秦皇岛": "BPE",
    "花土沟": "HTT",
    "承德": "CDE",
    "日照": "RIZ",
    "吕梁": "LLV",
    "德令哈": "HXD",
    "阿坝": "AHJ",
    "河池": "HCJ",
    "六盘水": "LPF",
    "霍林郭勒": "HUO",
    "白城": "DBC",
    "扎兰屯": "NZL",
    "忻州": "WUT",
    "营口": "YKH",
    "临汾": "LFQ",
    "上饶": "SQD",
    "松原": "YSQ",
    "十堰": "WDS",
    "乌兰察布": "UCB",
    "果洛": "GMQ",
    "澜沧": "JMJ",
    "沧源": "CWJ",
    "若羌": "RQA",
    "陇南": "LNL",
    "祁连": "HBQ",
    "信阳": "XAI",
    "宁蒗": "NLH",
    "长海": "CNI",
    "岳阳": "YYA",
    "图木舒克": "TWC",
    "巴中": "BZW",
    "阿拉尔": "ACF",
    "安阳": "AYN",
    "蚌埠": "BFU",
    "武隆": "CQW",
    "边城": "DXJ",
    "鄂州": "EHU",
    "甘孜": "GZG",
    "塔希库尔干": "HQL",
    "韶关": "HSC",
    "菏泽": "HZA",
    "奇台": "JBK",
    "九江": "JIU",
    "山南": "LGZ",
    "郴州": "LQP",
    "阆中": "LZG",
    "荆州": "SHS",
    "朔州": "SZH",
    "苏州": "SZV",
    "芜湖": "WHU",
    "武山": "WSK",
    "邢台": "XNT",
    "广西玉林": "YLX",
    "玉田": "YTW",
    "昭苏": "ZFL",
    "NaN": "WOT",
    "台中": "TXG",
    "连江": "LZN",
    "香港": "HKG",
    "澳门": "MFM",
    "台北": "TPE",
    "嘉义": "CYI",
    "恒春": "HCN",
    "花莲": "HUN",
    "高雄": "KHH",
    "金门": "KNH",
    "马公": "MZG",
    "北竿": "MFK",
    "屏东": "PIF",
    "台南": "TNN",
    "台东": "TTT",
    "七美": "CMJ",
    "绿岛": "GNI",
    "新竹": "HSZ",
    "兰屿": "KYD"
}