{
    "河北": "SJW",
    "山西": "TYN",
    "内蒙古": "HET",
    "辽宁": "SHE",
    "吉林": "CGQ",
    "黑龙江": "HRB",
    "江苏": "NKG",
    "浙江": "HGH",
    "安徽": "HFE",
    "福建": "FOC",
    "山东": "TNA",
    "江西": "KHN",
    "河南": "CGO",
    "新疆": "URC",
    "湖北": "WUH",
    "湖南": "CSX",
    "广东": "CAN",
    "广西": "NNG",
    "海南": "HAK",
    "四川": "CTU",
    "贵州": "KWE",
    "云南": "KMG",
    "西藏": "LXA",
    "陕西": "SIA",
    "青海": "XNN",
    "甘肃": "LHW",
    "宁夏": "INC",
    "台湾": "TPE"
  }